..............................................................7-------------------------9......................................................................
..............................................................+.........................+......................................................................
..............................................................+.........................+......................................................................
..............................................................+.........................+......................................................................
..............................................................+.........................+......................................................................
..............................................................+.........................+......................................................................
..............................................................+.........................+......................................................................
..............................................................+.........................+......................................................................
..............................................................+.........................+......................................................................
..............................................................+.........................+......................................................................
..............................................................+.........................+......................................................................
..............................................................+.........................+......................................................................
..............................................................+.........................+......................................................................
..............................................................+.........................+......................................................................
..............................................................+.........................+......................................................................
..............................................................+.........................+......................................................................
..............................................................+.........................+......................................................................
..............................................................+.........................+......................................................................
..............................................................+.........................+......................................................................
..............................................................+.........................+......................................................................
......................................7-----------------------3.........................1------------------------------------------9...........................
......................................+............................................................................................+...........................
......................................+............................................................................................+...........................
......................................+............................................................................................+...........................
......................................+............................................................................................+...........................
......................................+............................................................................................+...........................
......................................+............................................................................................+...........................
......................................+............................................................................................+...........................
......................................+........7----------------------------------------------------------------9..................+...........................
......................................+........+................................................................+..................+...........................
......................................+........+................................................................+..................+...........................
......................................+........+................................................................+..................+...........................
......................................+........+................................................................+..................+...........................
......................................+........+................................................................+..................+...........................
......................................+........+................................................................+..................+...........................
......................................+........+................................................................+..................+...........................
......................................+........+................................................................+..................+...........................
......................................+........+................................................................+..................+...........................
......................................+........+................................................................+..................+...........................
......................................+........+................................................................+..................+...........................
......................................+........+................................................................+..................+...........................
......................................+........+................................................................+..................+...........................
......................................+........+................................................................+..................+...........................
......................................+........+................................................................+..................+...........................
......................................+........+................................................................+..................+...........................
......................................+........+................................................................+..................+...........................
......................................+........+................................................................+..................+...........................
......................................+........+................................................................+..................+...........................
......................................+........+................................................................+..................+...........................
......................................+........+................................................................+..................+...........................
.................................7----3........1---------------------------------------9........................+..................+...........................
.................................+.....................................................+........................+..................+...........................
.................................+.....................................................+........................+..................+...........................
.................................+.....................................................+........................+..................+...........................
.................................+..............7-------------9........................+........................+..................+...........................
.................................+..............+.............+....................7---3........................+..................+...........................
.................................+..............+.............+....................+............................+..................+...........................
.................................+..............+.............+....................1---9........................+..................+...........................
.................................+..............+.............+........................+........................+..................+...........................
.................................+..............+.............+........................+........................+..................+...........................
.................................+..............+.............+........................+........................+..................+...........................
.................................+..............+.............+........................+........................+..................+...........................
.................................+..............+.............+........................+........................+..................+...........................
.................................+..............+.............+........................+........................+..................+...........................
.................................+..............+.............+........................+........................+..................+...........................
.................................+..............+.............+........................+........................+..................+...........................
.................................+..............+.............+........................+........................+..................+...........................
.................................+..............+.............+........................+........................+..................+...........................
.................................+..............+.............+........................1------------------------3..................+...........................
.................................+..............+.............+....................................................................+...........................
.................................+..............+.............+....................................................................+...........................
.................................+..............+.............+....................................................................+...........................
.................................+..............+.............+....................................................................+...........................
.................................+..............+.............+....................................................................+...........................
7--------------------------------3..............+.............+....................................................................+...........................
+...............................................+.............+....................................................................+...........................
+...............................................+.............+....................................................................+...........................
+...............................................+.............+....................................................................+...........................
+...............................................+.............+..............................7---------------------------9.........+...........................
+...............................................+.............+..............................+...........................+.........+...........................
+...............................................+.............+..............................+...........................+.........+...........................
+...............................................+.............+..............................+...........................+.........+...........................
+...............................................+.............+..............................+...........................+.........+...........................
+...............................................+.............+.......7---9..................+...........................+.........+...........................
+...............................................+.............+.......+...+..................+...........................+.........+...........................
+...............................................+.............+.......+...+..................+...........................+.........+...........................
+...............................................+.............+.......+...+..................+...........................+.........+...........................
+...............................................+.............+.......+...+..................+...........................+.........+...........................
+...............................................+.............+.......+...+..................+...........................+.........+...........................
+...............................................+.............+.......+...+..................+...........................+.........+...........................
+...............................................+.............+.......+...+..................+...........................+.........+...........................
+...............................................1-------------3.......+...+..................+...........................+.........+...........................
+.....................................................................+...+..................+.........7-----------------3.........+...........................
+.....................................................................+...+..................+.........+...........................+...........................
+.....................................................................+...+..................+.........+...........................+...........................
+.....................................................................+...+..................+.........+...........................+...........................
+.....................................................................+...+..................+.........+...........................+...........................
+.....................................................................+...+..................1---------3...........................+...........................
+.....................................................................+...+......................................7-------------9...1--------------------------9
+...............................................7---------------------3...1----9.................................+.............+..............................+
+...............................................+..............................+.............7---------9.........+.............+..............................+
+...............................................+..............................+.............+.........+.........+.............+..............................+
+...............................................+..............................+.............+.........+.........1---------9...+..............................+
+...............................................+..............................+.............+.........+...................+...+..............................+
+...............................................+..............................+.............+.........+...................+...+..............................+
+...............................................+..............................+.............+.........+...................+...+..............................+
+...............................................+..............................+.............+.........+...................+...+..............................+
+...............................................+..............................+.............+.........+...................+...+..............................+
+...............................................+..............................+.............+.........1-------------9.....+...+..............................+
+...............................................+..............................+.............+.......................+.....+...+..............................+
+...............................................+..............................+.............+.......................+.....+...+....................7---------3
+...............................................+..............................+.............+.......................+.....+...+....................+..........
+...............................................+..............................+.............+.......................+.....+...+....................+..........
+...............................................+..............................+.............+.......................+.....+...+....................+..........
+...............................................+..............................+.............+.......................+.....+...+....................+..........
+...............................................+..............................+.............+.......................+.....+...+....................+..........
1---------------------------------------9.......+..............................+.............+.......................+.....1---3....................+..........
........................................+.......+..............................+.............+.......................+..............................+..........
........................................+.......+..............................+.............+.......................+..............................+..........
........................................+.......+..............................+.............+.......................+..............................+..........
........................................+.......+..............................+.............+.......................+..............................+..........
........................................+.......+..............................+.............+.......................+..............................+..........
........................................+.......+..............................+.............+.......................+.....7-9......................+..........
........................................+.......+..............................+.............+.......................+.....+.+......................+..........
........................................+.......+..............................+.............+.......................+.....+.+......................+..........
........................................+.......+..............................+.............1-----------------------3.....+.+......................+..........
........................................+.......1------------------------------3...........................................+.+......................+..........
........................................+..................................................................................+.+......................+..........
........................................+..................................................................................+.+......................+..........
........................................+.......................................................................7----------3.1----------------------3..........
........................................+.......................................................................+..............................................
........................................+.......................................................................+..............................................
........................................+.......................................................................+..............................................
........................................1-------------------------------9.......................................+..............................................
........................................................................+.......................................+..............................................
........................................................................+.......................................+..............................................
........................................................................+.......................................+..............................................
........................................................................+.......................................+..............................................
........................................................................+.......................................+..............................................
........................................................................+.......................................+..............................................
........................................................................+.......................................+..............................................
........................................................................+.......................................+..............................................
........................................................................+.......................................+..............................................
........................................................................+.......................................+..............................................
........................................................................+.......................................+..............................................
........................................................................+.......................................+..............................................
........................................................................1---------------------------------------3..............................................
